###############
#1......x.....#
#.#.#.#.#.#.#.#
#..x..........#
#.#.#.#.#.#.#.#
#.............#
#.#.#.#.#.#.#.#
#......2......#
#.#.#.#.#.#.#.#
#.............#
#.#.#.#.#.#.#.#
#.............#
#.#.#.#.#.#.#.#
#.............#
###############